1111111111111111111111111111111111
1E0000000000X00C00000C000000000001
101X010100100000101001000XX0010101
101X010010101010001001000XX0010101
1P00000X0C00C0000000000000000000C1
1111111111111111111111111111111111